🟥🟥🟥🟥🟥🟥🟥🟥🟥🟥🟥🟥🟥🟥🟥🟥🟥🟥🟥🟥🟥🟥🟥🟥🟥🟥🟥🟥🟥🟥🟥🟥🟥🟥
🟥🟪🟨🟨🟨🟨🟨🟨🟨🟨🟨🟨🟨🟨🟨🟪🟥🟥🟪🟨🟨🟨🟨🟨🟨🟨🟨🟨🟨🟨🟨🟨🟪🟥
🟥🟨🟥🟥🟥🟥🟥🟨🟥🟥🟥🟥🟨🟥🟥🟨🟥🟥🟨🟥🟥🟨🟥🟥🟥🟥🟨🟥🟥🟥🟥🟥🟨🟥
🟥🟨🟥🟥🟥🟥🟥🟨🟥🟥🟥🟥🟨🟥🟥🟨🟥🟥🟨🟥🟥🟨🟥🟥🟥🟥🟨🟥🟥🟥🟥🟥🟨🟥
🟥🟨🟥🟥🟪🟨🟨🟨🟨🟨🟨🟨🟨🟨🟨🟨🟥🟥🟨🟨🟨🟨🟨🟨🟨🟨🟨🟨🟨🟪🟥🟥🟨🟥
🟥🟨🟥🟥🟨🟥🟥🟥🟥🟨🟥🟥🟥🟥🟥🟨🟨🟨🟨🟥🟥🟥🟥🟥🟨🟥🟥🟥🟥🟨🟥🟥🟨🟥
🟥🟨🟨🟨🟨🟥🟥🟥🟥🟨🟥🟥🟥🟥🟥🟨🟥🟥🟨🟥🟥🟥🟥🟥🟨🟥🟥🟥🟥🟨🟨🟨🟨🟥
🟥🟨🟥🟥🟨🟥🟥🟥🟥🟨🟥🟥🟥🟥🟥🟨🟥🟥🟨🟥🟥🟥🟥🟥🟨🟥🟥🟥🟥🟨🟥🟥🟨🟥
🟥🟨🟥🟥🟨🟨🟨🟨🟨🟨🟨🟨🟨🟨🟨🟪🟥🟥🟪🟨🟨🟨🟨🟨🟨🟨🟨🟨🟨🟨🟥🟥🟨🟥
🟥🟨🟨🟨🟨🟥🟥🟥🟥🟨🟥🟥🟨🟥🟥🟥🟥🟥🟥🟥🟥🟨🟥🟥🟨🟥🟥🟥🟥🟨🟨🟨🟨🟥
🟥🟨🟥🟥🟨🟥🟥🟥🟥🟨🟥🟥🟨🟥🟥🟥🟥🟥🟥🟥🟥🟨🟥🟥🟨🟥🟥🟥🟥🟨🟥🟥🟨🟥
🟥🟨🟥🟥🟪🟨🟨🟨🟨🟨🟥🟥🟪🟨🟨🟪🟥🟥🟪🟨🟨🟪🟥🟥🟨🟨🟨🟨🟨🟪🟥🟥🟨🟥
🟥🟨🟥🟥🟥🟥🟨🟥🟥🟨🟥🟥🟥🟥🟥🟨🟥🟥🟨🟥🟥🟥🟥🟥🟨🟥🟥🟨🟥🟥🟥🟥🟨🟥
🟥🟨🟥🟥🟥🟥🟨🟥🟥🟨🟥🟥🟥🟥🟥🟨🟥🟥🟨🟥🟥🟥🟥🟥🟨🟥🟥🟨🟥🟥🟥🟥🟨🟥
🟥🟪🟨🟨🟨🟨🟪🟥🟥🟨🟥🟥🟪🟨🟨🟨🟨🟨🟨🟨🟨🟪🟥🟥🟨🟥🟥🟪🟨🟨🟨🟨🟪🟥
🟥🟥🟥🟥🟨🟥🟥🟥🟥🟨🟥🟥🟨🟥🟥🟥🟨🟨🟥🟥🟥🟨🟥🟥🟨🟥🟥🟥🟥🟨🟥🟥🟥🟥
🟥🟥🟥🟥🟨🟥🟥🟥🟥🟨🟥🟥🟨🟥🟨🟨🟨🟨🟨🟨🟥🟨🟥🟥🟨🟥🟥🟥🟥🟨🟥🟥🟥🟥
🟥🟪🟨🟨🟨🟨🟨🟨🟨🟨🟨🟨🟨🟥🟨🟨🟨🟦🟨🟨🟥🟨🟨🟨🟨🟨🟨🟨🟨🟨🟨🟨🟪🟥
🟥🟥🟨🟥🟥🟥🟥🟨🟥🟥🟥🟥🟨🟥🟨🟨🟨🟨🟨🟨🟥🟨🟥🟥🟥🟥🟨🟥🟥🟥🟥🟨🟥🟥
🟥🟥🟨🟥🟥🟥🟥🟨🟥🟥🟥🟥🟨🟥🟥🟥🟥🟥🟥🟥🟥🟨🟥🟥🟥🟥🟨🟥🟥🟥🟥🟨🟥🟥
🟥🟪🟨🟨🟪🟥🟥🟪🟨🟪🟥🟥🟨🟨🟨🟨🟨🟨🟨🟨🟨🟨🟥🟥🟪🟨🟪🟥🟥🟪🟨🟨🟪🟥
🟥🟨🟥🟥🟨🟥🟥🟥🟥🟨🟥🟥🟨🟥🟥🟥🟥🟥🟥🟥🟥🟨🟥🟥🟨🟥🟥🟥🟥🟨🟥🟥🟨🟥
🟥🟨🟥🟥🟨🟥🟥🟥🟥🟨🟥🟥🟨🟥🟥🟥🟥🟥🟥🟥🟥🟨🟥🟥🟨🟥🟥🟥🟥🟨🟥🟥🟨🟥
🟥🟨🟨🟨🟨🟨🟨🟨🟨🟨🟨🟨🟨🟨🟨🟪🟥🟥🟪🟨🟨🟨🟨🟨🟨🟨🟨🟨🟨🟨🟨🟨🟨🟥
🟥🟨🟥🟥🟨🟥🟥🟥🟥🟨🟥🟥🟥🟥🟥🟨🟥🟥🟨🟥🟥🟥🟥🟥🟨🟥🟥🟥🟥🟨🟥🟥🟨🟥
🟥🟨🟥🟥🟨🟥🟥🟥🟥🟨🟥🟥🟥🟥🟥🟨🟥🟥🟨🟥🟥🟥🟥🟥🟨🟥🟥🟥🟥🟨🟥🟥🟨🟥
🟥🟨🟥🟥🟪🟨🟪🟥🟥🟨🟨🟨🟨🟨🟨🟨🟨🟨🟨🟨🟨🟨🟨🟨🟨🟥🟥🟪🟨🟪🟥🟥🟨🟥
🟥🟨🟥🟥🟥🟥🟨🟥🟥🟨🟥🟥🟨🟥🟥🟥🟥🟥🟥🟥🟥🟨🟥🟥🟨🟥🟥🟨🟥🟥🟥🟥🟨🟥
🟥🟨🟥🟥🟥🟥🟨🟥🟥🟨🟥🟥🟨🟥🟥🟥🟥🟥🟥🟥🟥🟨🟥🟥🟨🟥🟥🟨🟥🟥🟥🟥🟨🟥
🟥🟨🟨🟨🟨🟨🟨🟨🟨🟪🟥🟥🟪🟨🟨🟪🟥🟥🟪🟨🟨🟪🟥🟥🟪🟨🟨🟨🟨🟨🟨🟨🟨🟥
🟥🟨🟥🟥🟥🟨🟥🟥🟥🟥🟥🟥🟥🟥🟥🟨🟥🟥🟨🟥🟥🟥🟥🟥🟥🟥🟥🟥🟨🟥🟥🟩🟨🟥
🟥🟨🟥🟥🟥🟨🟥🟥🟥🟥🟥🟥🟥🟥🟥🟨🟥🟥🟨🟥🟥🟥🟥🟥🟥🟥🟥🟥🟨🟥🟥🟩🟨🟥
🟥🟨🟨🟨🟨🟨🟨🟨🟨🟨🟨🟨🟨🟨🟨🟨🟨🟨🟨🟨🟨🟨🟨🟨🟨🟨🟨🟨🟨🟨🟨🟨🟨🟥
🟥🟥🟥🟥🟥🟥🟥🟥🟥🟥🟥🟥🟥🟥🟥🟥🟥🟥🟥🟥🟥🟥🟥🟥🟥🟥🟥🟥🟥🟥🟥🟥🟥🟥

🟦 - Player & Pacman spawn
🟩 - Escape / hideout
🟥 - Wall
🟨 - Path
🟪 - Path + chance for key