🟥🟥🟥🟥🟥🟥🟥🟥🟥🟥🟥🟥🟥🟥🟥🟥🟥🟥🟥🟥🟥🟥🟥🟥🟥🟥🟥🟥🟥🟥🟥🟥🟥🟥🟥
🟥🟥🟪🟨🟨🟨🟨🟨🟨🟨🟨🟨🟨🟨🟨🟨🟪🟥🟥🟪🟨🟨🟨🟨🟨🟨🟨🟨🟨🟨🟨🟨🟨🟪🟥
🟥🟥🟨🟥🟥🟥🟥🟥🟨🟥🟥🟥🟥🟨🟥🟥🟨🟥🟥🟨🟥🟥🟨🟥🟥🟥🟥🟨🟥🟥🟥🟥🟥🟨🟥
🟥🟥🟨🟥🟥🟥🟥🟥🟨🟥🟥🟥🟥🟨🟥🟥🟨🟥🟥🟨🟥🟥🟨🟥🟥🟥🟥🟨🟥🟥🟥🟥🟥🟨🟥
🟥🟥🟨🟥🟥🟪🟨🟨🟨🟨🟨🟨🟨🟨🟨🟨🟨🟥🟥🟨🟨🟨🟨🟨🟨🟨🟨🟨🟨🟨🟪🟥🟥🟨🟥
🟥🟥🟨🟥🟥🟨🟥🟥🟥🟥🟨🟥🟥🟥🟥🟥🟨🟨🟨🟨🟥🟥🟥🟥🟥🟨🟥🟥🟥🟥🟨🟥🟥🟨🟥
🟥🟥🟨🟨🟨🟨🟥🟥🟥🟥🟨🟥🟥🟥🟥🟥🟨🟥🟥🟨🟥🟥🟥🟥🟥🟨🟥🟥🟥🟥🟨🟨🟨🟨🟥
🟥🟥🟨🟥🟥🟨🟥🟥🟥🟥🟨🟥🟥🟥🟥🟥🟨🟥🟥🟨🟥🟥🟥🟥🟥🟨🟥🟥🟥🟥🟨🟥🟥🟨🟥
🟥🟥🟨🟥🟥🟨🟨🟨🟨🟨🟨🟨🟨🟨🟨🟨🟪🟥🟥🟪🟨🟨🟨🟨🟨🟨🟨🟨🟨🟨🟨🟥🟥🟨🟥
🟥🟥🟨🟨🟨🟨🟥🟥🟥🟥🟨🟥🟥🟨🟥🟥🟥🟥🟥🟥🟥🟥🟨🟥🟥🟨🟥🟥🟥🟥🟨🟨🟨🟨🟥
🟥🟥🟨🟥🟥🟨🟥🟥🟥🟥🟨🟥🟥🟨🟥🟥🟥🟥🟥🟥🟥🟥🟨🟥🟥🟨🟥🟥🟥🟥🟨🟥🟥🟨🟥
🟥🟥🟨🟥🟥🟪🟨🟨🟨🟨🟨🟥🟥🟪🟨🟨🟪🟥🟥🟪🟨🟨🟪🟥🟥🟨🟨🟨🟨🟨🟪🟥🟥🟨🟥
🟥🟥🟨🟥🟥🟥🟥🟨🟥🟥🟨🟥🟥🟥🟥🟥🟨🟥🟥🟨🟥🟥🟥🟥🟥🟨🟥🟥🟨🟥🟥🟥🟥🟨🟥
🟥🟥🟨🟥🟥🟥🟥🟨🟥🟥🟨🟥🟥🟥🟥🟥🟨🟥🟥🟨🟥🟥🟥🟥🟥🟨🟥🟥🟨🟥🟥🟥🟥🟨🟥
🟥🟥🟪🟨🟨🟨🟨🟪🟥🟥🟨🟥🟥🟪🟨🟨🟨🟨🟨🟨🟨🟨🟪🟥🟥🟨🟥🟥🟪🟨🟨🟨🟨🟪🟥
🟥🟥🟥🟥🟥🟨🟥🟥🟥🟥🟨🟥🟥🟨🟥🟥🟥🟨🟨🟥🟥🟥🟨🟥🟥🟨🟥🟥🟥🟥🟨🟥🟥🟥🟥
🟥🟥🟥🟥🟥🟨🟥🟥🟥🟥🟨🟥🟥🟨🟥🟨🟨🟨🟨🟨🟨🟥🟨🟥🟥🟨🟥🟥🟥🟥🟨🟥🟥🟥🟥
🟥🟥🟪🟨🟨🟨🟨🟨🟨🟨🟨🟨🟨🟨🟥🟨🟨🟨🟦🟨🟨🟥🟨🟨🟨🟨🟨🟨🟨🟨🟨🟨🟨🟪🟥
🟥🟥🟥🟨🟥🟥🟥🟥🟨🟥🟥🟥🟥🟨🟥🟨🟨🟨🟨🟨🟨🟥🟨🟥🟥🟥🟥🟨🟥🟥🟥🟥🟨🟥🟥
🟥🟥🟥🟨🟥🟥🟥🟥🟨🟥🟥🟥🟥🟨🟥🟥🟥🟥🟥🟥🟥🟥🟨🟥🟥🟥🟥🟨🟥🟥🟥🟥🟨🟥🟥
🟥🟥🟪🟨🟨🟪🟥🟥🟪🟨🟪🟥🟥🟨🟨🟨🟨🟨🟨🟨🟨🟨🟨🟥🟥🟪🟨🟪🟥🟥🟪🟨🟨🟪🟥
🟥🟥🟨🟥🟥🟨🟥🟥🟥🟥🟨🟥🟥🟨🟥🟥🟥🟥🟥🟥🟥🟥🟨🟥🟥🟨🟥🟥🟥🟥🟨🟥🟥🟨🟥
🟥🟥🟨🟥🟥🟨🟥🟥🟥🟥🟨🟥🟥🟨🟥🟥🟥🟥🟥🟥🟥🟥🟨🟥🟥🟨🟥🟥🟥🟥🟨🟥🟥🟨🟥
🟥🟥🟨🟨🟨🟨🟨🟨🟨🟨🟨🟨🟨🟨🟨🟨🟪🟥🟥🟪🟨🟨🟨🟨🟨🟨🟨🟨🟨🟨🟨🟨🟨🟨🟥
🟥🟥🟨🟥🟥🟨🟥🟥🟥🟥🟨🟥🟥🟥🟥🟥🟨🟥🟥🟨🟥🟥🟥🟥🟥🟨🟥🟥🟥🟥🟨🟥🟥🟨🟥
🟥🟥🟨🟥🟥🟨🟥🟥🟥🟥🟨🟥🟥🟥🟥🟥🟨🟥🟥🟨🟥🟥🟥🟥🟥🟨🟥🟥🟥🟥🟨🟥🟥🟨🟥
🟥🟥🟨🟥🟥🟪🟨🟪🟥🟥🟨🟨🟨🟨🟨🟨🟨🟨🟨🟨🟨🟨🟨🟨🟨🟨🟥🟥🟪🟨🟪🟥🟥🟨🟥
🟥🟥🟨🟥🟥🟥🟥🟨🟥🟥🟨🟥🟥🟨🟥🟥🟥🟥🟥🟥🟥🟥🟨🟥🟥🟨🟥🟥🟨🟥🟥🟥🟥🟨🟥
🟥🟥🟨🟥🟥🟥🟥🟨🟥🟥🟨🟥🟥🟨🟥🟥🟥🟥🟥🟥🟥🟥🟨🟥🟥🟨🟥🟥🟨🟥🟥🟥🟥🟨🟥
🟥🟥🟨🟨🟨🟨🟨🟨🟨🟨🟪🟥🟥🟪🟨🟨🟪🟥🟥🟪🟨🟨🟪🟥🟥🟪🟨🟨🟨🟨🟨🟨🟨🟨🟥
🟥🟥🟨🟥🟥🟥🟨🟥🟥🟥🟥🟥🟥🟥🟥🟥🟨🟥🟥🟨🟥🟥🟥🟥🟥🟥🟥🟥🟥🟨🟥🟥🟩🟨🟥
🟥🟥🟨🟥🟥🟥🟨🟥🟥🟥🟥🟥🟥🟥🟥🟥🟨🟥🟥🟨🟥🟥🟥🟥🟥🟥🟥🟥🟥🟨🟥🟥🟩🟨🟥
🟥🟥🟨🟨🟨🟨🟨🟨🟨🟨🟨🟨🟨🟨🟨🟨🟨🟨🟨🟨🟨🟨🟨🟨🟨🟨🟨🟨🟨🟨🟨🟨🟨🟨🟥
🟥🟥🟥🟥🟥🟥🟥🟥🟥🟥🟥🟥🟥🟥🟥🟥🟥🟥🟥🟥🟥🟥🟥🟥🟥🟥🟥🟥🟥🟥🟥🟥🟥🟥🟥