🟥🟥🟥🟥🟥🟥🟥🟥🟥🟥🟥🟥🟥🟥🟥🟥🟥🟥🟥🟥🟥🟥🟥🟥🟥🟥🟥🟥🟥🟥🟥🟥🟥🟥
🟥🟨🟨🟨🟨🟨🟨🟨🟨🟨🟨🟨🟨🟨🟨🟪🟥🟥🟪🟨🟨🟨🟨🟨🟨🟨🟨🟨🟨🟨🟨🟨🟨🟥
🟥🟨🟥🟥🟥🟥🟥🟨🟥🟥🟥🟥🟨🟥🟥🟨🟥🟥🟨🟥🟥🟨🟥🟥🟥🟥🟨🟥🟥🟥🟥🟥🟨🟥
🟥🟨🟥🟥🟥🟥🟥🟨🟥🟥🟥🟥🟨🟥🟥🟨🟥🟥🟨🟥🟥🟨🟥🟥🟥🟥🟨🟥🟥🟥🟥🟥🟨🟥
🟥🟨🟥🟥🟪🟨🟨🟨🟨🟨🟨🟨🟨🟨🟨🟨🟥🟥🟨🟨🟨🟨🟨🟨🟨🟨🟨🟨🟨🟪🟥🟥🟨🟥
🟥🟨🟥🟥🟨🟥🟥🟥🟥🟨🟥🟥🟥🟥🟥🟨🟨🟨🟨🟥🟥🟥🟥🟥🟨🟥🟥🟥🟥🟨🟥🟥🟨🟥
🟥🟨🟨🟨🟨🟥🟥🟥🟥🟨🟥🟥🟥🟥🟥🟨🟥🟥🟨🟥🟥🟥🟥🟥🟨🟥🟥🟥🟥🟨🟨🟨🟨🟥
🟥🟨🟥🟥🟨🟥🟥🟥🟥🟨🟥🟥🟥🟥🟥🟨🟥🟥🟨🟥🟥🟥🟥🟥🟨🟥🟥🟥🟥🟨🟥🟥🟨🟥
🟥🟨🟥🟥🟨🟨🟨🟨🟨🟨🟨🟨🟨🟨🟨🟪🟥🟥🟪🟨🟨🟨🟨🟨🟨🟨🟨🟨🟨🟨🟥🟥🟨🟥
🟥🟨🟨🟨🟨🟥🟥🟥🟥🟨🟥🟥🟨🟥🟥🟥🟥🟥🟥🟥🟥🟨🟥🟥🟨🟥🟥🟥🟥🟨🟨🟨🟨🟥
🟥🟨🟥🟥🟨🟥🟥🟥🟥🟨🟥🟥🟨🟥🟥🟥🟥🟥🟥🟥🟥🟨🟥🟥🟨🟥🟥🟥🟥🟨🟥🟥🟨🟥
🟥🟨🟥🟥🟪🟨🟨🟨🟨🟨🟥🟥🟪🟨🟨🟪🟥🟥🟪🟨🟨🟪🟥🟥🟨🟨🟨🟨🟨🟪🟥🟥🟨🟥
🟥🟨🟥🟥🟥🟥🟨🟥🟥🟨🟥🟥🟥🟥🟥🟨🟥🟥🟨🟥🟥🟥🟥🟥🟨🟥🟥🟨🟥🟥🟥🟥🟨🟥
🟥🟨🟥🟥🟥🟥🟨🟥🟥🟨🟥🟥🟥🟥🟥🟨🟥🟥🟨🟥🟥🟥🟥🟥🟨🟥🟥🟨🟥🟥🟥🟥🟨🟥
🟥🟪🟨🟨🟨🟨🟪🟥🟥🟨🟥🟥🟨🟨🟨🟨🟨🟨🟨🟨🟨🟨🟥🟥🟨🟥🟥🟪🟨🟨🟨🟨🟨🟥
🟥🟥🟥🟥🟨🟥🟥🟥🟥🟨🟥🟥🟨🟥🟥🟥🟨🟨🟥🟥🟥🟨🟥🟥🟨🟥🟥🟥🟥🟨🟥🟥🟥🟥
🟥🟥🟥🟥🟨🟥🟥🟥🟥🟨🟥🟥🟨🟥🟨🟨🟨🟨🟨🟨🟥🟨🟥🟥🟨🟥🟥🟥🟥🟨🟥🟥🟥🟥
🟥🟪🟨🟨🟨🟨🟨🟨🟨🟨🟨🟨🟨🟥🟨🟨🟨🟦🟨🟨🟥🟨🟨🟨🟨🟨🟨🟨🟨🟨🟨🟨🟨🟥
🟥🟥🟨🟥🟥🟥🟥🟨🟥🟥🟥🟥🟨🟥🟨🟨🟨🟨🟨🟨🟥🟨🟥🟥🟥🟥🟨🟥🟥🟥🟥🟨🟥🟥
🟥🟥🟨🟥🟥🟥🟥🟨🟥🟥🟥🟥🟨🟥🟥🟥🟥🟥🟥🟥🟥🟨🟥🟥🟥🟥🟨🟥🟥🟥🟥🟨🟥🟥
🟥🟪🟨🟨🟪🟥🟥🟪🟨🟪🟥🟥🟨🟨🟨🟨🟨🟨🟨🟨🟨🟨🟥🟥🟪🟨🟪🟥🟥🟪🟨🟨🟨🟥
🟥🟨🟥🟥🟨🟥🟥🟥🟥🟨🟥🟥🟨🟥🟥🟥🟥🟥🟥🟥🟥🟨🟥🟥🟨🟥🟥🟥🟥🟨🟥🟥🟨🟥
🟥🟨🟥🟥🟨🟥🟥🟥🟥🟨🟥🟥🟨🟥🟥🟥🟥🟥🟥🟥🟥🟨🟥🟥🟨🟥🟥🟥🟥🟨🟥🟥🟨🟥
🟥🟨🟨🟨🟨🟨🟨🟨🟨🟨🟨🟨🟨🟨🟨🟪🟥🟥🟪🟨🟨🟨🟨🟨🟨🟨🟨🟨🟨🟨🟨🟨🟨🟥
🟥🟨🟥🟥🟨🟥🟥🟥🟥🟨🟥🟥🟥🟥🟥🟨🟥🟥🟨🟥🟥🟥🟥🟥🟨🟥🟥🟥🟥🟨🟥🟥🟨🟥
🟥🟨🟥🟥🟨🟥🟥🟥🟥🟨🟥🟥🟥🟥🟥🟨🟥🟥🟨🟥🟥🟥🟥🟥🟨🟥🟥🟥🟥🟨🟥🟥🟨🟥
🟥🟨🟥🟥🟪🟨🟪🟥🟥🟨🟨🟨🟨🟨🟨🟨🟨🟨🟨🟨🟨🟨🟨🟨🟨🟥🟥🟪🟨🟪🟥🟥🟨🟥
🟥🟨🟥🟥🟥🟥🟨🟥🟥🟨🟥🟥🟨🟥🟥🟥🟥🟥🟥🟥🟥🟨🟥🟥🟨🟥🟥🟨🟥🟥🟥🟥🟨🟥
🟥🟨🟥🟥🟥🟥🟨🟥🟥🟨🟥🟥🟨🟥🟥🟥🟥🟥🟥🟥🟥🟨🟥🟥🟨🟥🟥🟨🟥🟥🟥🟥🟨🟥
🟥🟨🟨🟨🟨🟨🟨🟨🟨🟪🟥🟥🟪🟨🟨🟪🟥🟥🟪🟨🟨🟪🟥🟥🟪🟨🟨🟨🟨🟨🟨🟨🟨🟥
🟥🟨🟥🟥🟥🟨🟥🟥🟥🟥🟥🟥🟥🟥🟥🟨🟥🟥🟨🟥🟥🟥🟥🟥🟥🟥🟥🟥🟨🟥🟧🟩🟨🟥
🟥🟨🟥🟥🟥🟨🟥🟥🟥🟥🟥🟥🟥🟥🟥🟨🟥🟥🟨🟥🟥🟥🟥🟥🟥🟥🟥🟥🟨🟥🟧🟩🟨🟥
🟥🟨🟨🟨🟨🟨🟨🟨🟨🟨🟨🟨🟨🟨🟨🟨🟨🟨🟨🟨🟨🟨🟨🟨🟨🟨🟨🟨🟨🟨🟨🟨🟨🟥
🟥🟥🟥🟥🟥🟥🟥🟥🟥🟥🟥🟥🟥🟥🟥🟥🟥🟥🟥🟥🟥🟥🟥🟥🟥🟥🟥🟥🟥🟥🟥🟥🟥🟥